NO ./textures/north.xpm
SO ./textures/dirty_south.xpm
WE ./textures/west.xpm
EA ./textures/east.xpm

F 61, 66, 74
C 27, 28, 31

1111111111
1000000001
111100O001
1000000001
100N001001
1000001001
100000100111111111
111111100000000001
      10000O000001
      100000000001
      10000111D111
      100001000001
      100001000001
      111111111111