NO ./textures/NO.png
SO ./textures/SO.png
EA ./textures/EA.png
WE ./textures/WE.png

C 12, 254, 78
F 45, 65, 12

1111111111111111111111111
100N000000000000000000001
1111111111111111111111111