NO ./textures/north.xpm
SO ./textures/dirty_south.xpm
WE ./textures/west.xpm
EA ./textures/east.xpm

F 117, 142, 79
C 35, 245, 251


1111111111
1000000001
1111000O01
1000000001
1000001001
1000001001
100000100111111111
111111100000000001
      100000000S01
      100000000001
      10000111D111
      100001000001
      100001000001
      111111111111