NO ./textures/north.xpm
SO ./textures/dirty_south.xpm
WE ./textures/west.xpm
EA ./textures/east.xpm

C 117, 142, 79
F 135, 245, 251

11111111111111111111111111111111111111111111111111111111111111111111111111111111
10000000000000000000100000000000011111110000000000000000000000000000000000000001
100E000000100000O000D00000000000000000000000000000000000000000000000000000000001
100000000010000000001000000000000000000000000100000000000000000000000O0000000001
11111111111011111111100100100011111000000000010000000000000000000000000000000001
10000000000000000000100000000000001000000000010000000000000000000000000000000001
10000000000000000000100000000000001000000000010000000000000000000000000000000001
10000O000000000000001000000000000010000O000001000000000000O000000000000000000001
100000000000000000001000000O0000001000000000010000000000000000000000000000000001
10000000000000000000100000000000001000000000010000000000000000000000000000000001
10000000000000000000100000000000001000000000010000000000000000000000000000000001
10000000000000000000100000000000001000000000000000000000000000000000000000000001
10000000000000000000111111111111111000000000000000000000000000000000000000000001
10000000000000000000000000000000000000000000000000000000000000000000000000000001
100000000000000000000000000000000000000000000000000000000000000000000O0000000001
10000000000000000000000000000000000000000000000000000000000000000000000000000001
1000000000000000000O0000000000000000000O0000000000000000000000000000000000000001
10000000000000000000000000000000000000000000000000000000000100000000000000000001
10000000000000000000000000000000000000000000000000000000000000000000000000000001
10000000000000000000000000000000000000000000000000000000000000000000000000000001             
10000000000000011111111110011111111100000000000000000000000000000000000000000001
10000000000000010000000000000000000100000000000000000000000000000000000000000001
10000000000000010000000111110000000100000000000000000000000000000000000000000001
100000000000000100000001   10000000100000000000000000000001111000000000000000001
100000000000000100000001   10000000100000000000000000000001001000000000000000001
10000000000000010000000111110000000100000000000000000100001111000000000000000001
10000000000000010000000000000000000100000000000000000000000000000000000000000001
100000000000000111111111111111111111000000000000000000000000000000000O0000000001
10000000010111110000000000000000000000000000000000000000000000000000000000000001
1000000001000000000000000000000000000000O000000000000000000000O00000000000000001
10000O00010000000000000000000000000000000000000000000000000000000000000000000001
100000000100000000O000000000O000000000000000000000000000000000000000000000000001
10000000010000000000000000000000000000000000000000000000000000000000000000000001
10000000010000000000000000000000000000000000000000000000000000000000000000000001
10000000010000000000000000000000000000000000000000000000000000000000000000000001
10000000010000000000000000000000000000000000000000000000000000000000000000000001
11111111111111111111111111111111111111111111111111111111111111111111111111111111