NO ./textures/bluestone.xpm

SO ./textures/colorstone.xpm
WE ./textures/greystone.xpm
EA        ./textures/redbrick.xpm


F 124,    142, 12

     C     12, 220,    125

1111111111
1000000101
1111000011
1000000001
100N001001
1100001001
1010001001
1111111111