NO ./textures/north.xpm
SO ./textures/south.xpm
EA ./textures/east.xpm
WE ./textures/west.xpm

C 12, 254, 78
F 45, 65, 12

1111111111111111111
1000000000000000001
100000000000000S001
1000000000000000001
1000000000000000001
1111111111111111111