R 1080 1042

NO ./textures/bluestone.xpm
SO ./textures/colorstone.xpm
WE ./textures/greystone.xpm
EA ./textures/redbrick.xpm

F 117, 142, 79
C 135, 245, 251

1111111111
1000000001
1111000001
1000000001
100N001001
1020001021
1000001001
1111111111