WE ./textures/greystone.xpm
NO ./textures/bluestone.xpm

     C     12, 220,    125
SO ./textures/colorstone.xpm
EA        ./textures/redbrick.xpm

F 124,    142, 12



1111111111
1000000001
1111000001
1000000001
100E001001
1000001001
1000001001
1111111111